#############################
#....###############...#...##
#.##.................#.#.#..#
S.####################...##.#
##########################..#
#..........................##
#.###########################
#...........................E
#############################
